XXXXXXXXXXXXXXXXXXXX
X     XXXXX   XX   X
X XXX   XX   XXX XXX
X XXX X XXXX      XX
X XXX X XXXXXXXX   X
X XX XX     XXXXX XX
X XX XXX X XXXXXX  X
X     XX X XXXXXXX X
X XXXXXX X         X
XXXXXXXXXXXXXXXXXXXX